"filename", "language", "Dart", "comment", "blank", "total"
"d:\Codes\Test\Flutter\qvise\test\core\data\unit_of_work_test.dart", "Dart", 68, 11, 12, 91
"d:\Codes\Test\Flutter\qvise\test\core\utils\password_validator_test.dart", "Dart", 24, 1, 7, 32
"d:\Codes\Test\Flutter\qvise\test\features\auth\data\repositories\auth_repository_impl_test.dart", "Dart", 89, 16, 11, 116
"d:\Codes\Test\Flutter\qvise\test\features\auth\domain\usecases\sign_in_with_email_password_test.dart", "Dart", 23, 4, 6, 33
"d:\Codes\Test\Flutter\qvise\test\features\content\data\repositories\content_repository_impl_test.dart", "Dart", 154, 20, 19, 193
"d:\Codes\Test\Flutter\qvise\test\features\content\domain\usecases\create_lesson_test.dart", "Dart", 39, 4, 6, 49
"d:\Codes\Test\Flutter\qvise\test\features\content\domain\usecases\delete_lesson_test.dart", "Dart", 21, 4, 5, 30
"d:\Codes\Test\Flutter\qvise\test\features\flashcards\creation\domain\usecases\create_flashcard_test.dart", "Dart", 46, 4, 6, 56
"d:\Codes\Test\Flutter\qvise\test\features\flashcards\creation\domain\usecases\update_flashcard_test.dart", "Dart", 32, 4, 6, 42
"d:\Codes\Test\Flutter\qvise\test\features\flashcards\shared\data\repositories\flashcard_repository_impl_test.dart", "Dart", 120, 16, 15, 151
"d:\Codes\Test\Flutter\qvise\test\mocks.dart", "Dart", 34, 1, 1, 36
"d:\Codes\Test\Flutter\qvise\test\test_config.dart", "Dart", 10, 4, 3, 17
"d:\Codes\Test\Flutter\qvise\test\test_helpers.dart", "Dart", 63, 6, 16, 85
"d:\Codes\Test\Flutter\qvise\test\widget_test.dart", "Dart", 79, 18, 16, 113
"Total", "-", 802, 113, 129, 1044